"aD" = (/obj/structure/flora/grass/both,/turf/simulated/floor/grass,/area/nativitas)
"cX" = (/turf/simulated/floor/carpet/blue,/area/nativitas)
"fA" = (/obj/effect/wallframe_spawn/reinforced,/turf/simulated/floor/lino,/area/nativitas)
"fL" = (/turf/simulated/floor/tiled/skrell/orange,/area/nativitas)
"gt" = (/turf/simulated/floor/tiled/skrell/green,/area/nativitas)
"gF" = (/turf/simulated/floor/wood/mahogany,/area/nativitas)
"hR" = (/obj/machinery/computer/modular{dir = 8},/turf/simulated/floor/lino,/area/nativitas)
"hX" = (/turf/simulated/floor/tiled/monofloor,/area/nativitas)
"is" = (/obj/machinery/vending/sol{dir = 8},/turf/simulated/floor/reinforced,/area/nativitas)
"jQ" = (/obj/structure/flora/seaweed,/turf/simulated/floor/beach/water/ocean,/area/nativitas)
"kW" = (/turf/simulated/floor/tiled,/area/nativitas)
"lk" = (/turf/simulated/floor/beach/water,/area/nativitas)
"lm" = (/turf/exterior/wildgrass,/area/nativitas)
"mX" = (/turf/simulated/floor/beach/coastline,/area/nativitas)
"mY" = (/turf/simulated/floor/lino,/area/nativitas)
"nk" = (/obj/structure/bed/sofa/right/beige{dir = 1},/turf/simulated/floor/tiled,/area/nativitas)
"nL" = (/obj/structure/flora/tree/pine,/turf/exterior/wildgrass,/area/nativitas)
"ol" = (/obj/structure/bed/sofa/right/beige,/turf/simulated/floor/tiled,/area/nativitas)
"ql" = (/turf/simulated/floor/tiled/stone,/area/nativitas)
"qw" = (/turf/simulated/floor/wood/bamboo,/area/nativitas)
"qU" = (/turf/simulated/floor/tiled/skrell/white,/area/nativitas)
"qY" = (/turf/simulated/floor/wood/usedup,/area/nativitas)
"sh" = (/obj/structure/bed/sofa/middle/beige{dir = 1},/turf/simulated/floor/tiled,/area/nativitas)
"tq" = (/turf/simulated/floor/grass,/area/nativitas)
"tB" = (/obj/machinery/computer/modular{dir = 4},/turf/simulated/floor/lino,/area/nativitas)
"uM" = (/turf/simulated/floor/beach/water/ocean,/area/nativitas)
"vm" = (/obj/structure/bed/sofa/middle/beige,/turf/simulated/floor/tiled,/area/nativitas)
"vM" = (/obj/effect/wallframe_spawn/reinforced,/turf/simulated/floor/reinforced,/area/nativitas)
"wd" = (/obj/structure/flora/grass/green,/turf/simulated/floor/grass,/area/nativitas)
"wg" = (/turf/space,/area/nativitas)
"xj" = (/obj/structure/flora/bush/palebush,/turf/simulated/floor/grass,/area/nativitas)
"yr" = (/obj/structure/flora/bush/pointybush,/turf/simulated/floor/grass,/area/nativitas)
"yC" = (/obj/structure/flora/seaweed,/turf/simulated/floor/beach/water,/area/nativitas)
"yM" = (/obj/structure/bed/sofa/left/beige{dir = 1},/turf/simulated/floor/tiled,/area/nativitas)
"yZ" = (/obj/structure/flora/bush/fernybush,/turf/simulated/floor/grass,/area/nativitas)
"zd" = (/obj/structure/bed/chair/padded/black{dir = 8},/turf/simulated/floor/lino,/area/nativitas)
"Az" = (/turf/simulated/floor/tiled/skrell/red,/area/nativitas)
"AT" = (/obj/structure/bed/chair/pew/left/mahogany,/turf/simulated/floor/wood/ebony,/area/nativitas)
"Be" = (/turf/simulated/floor/wood/ebony,/area/nativitas)
"Bt" = (/turf/simulated/floor/beach/sand,/area/nativitas)
"BG" = (/turf/simulated/floor/tiled/white,/area/nativitas)
"Co" = (/turf/simulated/floor/reinforced,/area/nativitas)
"CF" = (/obj/effect/wallframe_spawn/reinforced,/turf/simulated/floor/wood/bamboo,/area/nativitas)
"Dn" = (/obj/structure/flora/bush/stalkybush,/turf/simulated/floor/grass,/area/nativitas)
"Ee" = (/obj/machinery/power/debug_items/infinite_generator,/obj/structure/cable{icon_state = "0-1"; dir = 4},/turf/simulated/floor,/area/nativitas)
"Gt" = (/obj/structure/bed/sofa/left/beige,/turf/simulated/floor/tiled,/area/nativitas)
"Is" = (/obj/structure/aicore,/turf/simulated/floor/reinforced,/area/nativitas)
"Iy" = (/obj/structure/flora/bush/brflowers,/turf/simulated/floor/grass,/area/nativitas)
"IQ" = (/obj/structure/bed/chair/pew/mahogany,/turf/simulated/floor/wood/ebony,/area/nativitas)
"Ju" = (/obj/structure/flora/bush/grassybush,/turf/simulated/floor/grass,/area/nativitas)
"JN" = (/obj/structure/bed/chair/padded/black{dir = 4},/turf/simulated/floor/lino,/area/nativitas)
"KC" = (/obj/structure/table/woodentable/walnut,/turf/simulated/floor/lino,/area/nativitas)
"KK" = (/obj/structure/charge_pylon,/turf/simulated/floor/crystal,/area/nativitas)
"KX" = (/obj/structure/flora/seaweed/mid,/turf/simulated/floor/beach/water,/area/nativitas)
"Lg" = (/obj/structure/flora/seaweed/large,/turf/simulated/floor/beach/water,/area/nativitas)
"Lm" = (/obj/structure/flora/seaweed/large,/turf/simulated/floor/beach/water/ocean,/area/nativitas)
"Mw" = (/obj/machinery/power/apc/high{dir = 8; name = "west bump"; pixel_x = -24},/obj/structure/cable{icon_state = "0-1"; dir = 8},/turf/simulated/floor,/area/nativitas)
"OV" = (/obj/structure/flora/seaweed/glow,/turf/simulated/floor/beach/water/ocean,/area/nativitas)
"Pa" = (/turf/simulated/wall/ocp_wall,/area/nativitas)
"Ps" = (/obj/structure/flora/seaweed,/turf/simulated/floor/beach/coastline,/area/nativitas)
"PR" = (/obj/effect/wallframe_spawn/reinforced,/turf/space,/area/nativitas)
"Qd" = (/turf/simulated/floor/carpet/red,/area/nativitas)
"QH" = (/turf/simulated/floor/greengrid,/area/nativitas)
"RL" = (/obj/structure/flora/seaweed/mid,/turf/simulated/floor/beach/coastline,/area/nativitas)
"SF" = (/obj/structure/mineral_bath,/turf/simulated/floor/crystal,/area/nativitas)
"Uu" = (/turf/simulated/floor/tiled/skrell/blue,/area/nativitas)
"Wl" = (/obj/structure/table/reinforced,/turf/simulated/floor/reinforced,/area/nativitas)
"Wn" = (/turf/simulated/floor/bluegrid,/area/nativitas)
"Wu" = (/turf/simulated/floor,/area/nativitas)
"Yn" = (/turf/simulated/floor/crystal,/area/nativitas)

(1,1,1) = {"
wgwgwgwgwgwgwgwgwgwgwgwgwgwgwgwgwgwgwgwgwgwgwgwgwgwgwgwgwgwgwgwgwgwgwgwgwgwgwgwgwgwgwgwgwgwgwgwgwgwgwgwgwgwgwgwgwgwgwgwgwgwgwgwgwgwgwgwgwgwgwgwgwgwgwg
wgwgwgwgwgwgwgwgwgwgwgwgwgwgwgwgwgwgwgwgwgwgwgwgwgwgwgwgwgwgwgwgwgwgwgwgwgwgwgwgwgwgwgwgwgwgwgwgwgwgwgwgwgwgwgwgwgwgwgwgwgwgwgwgwgwgwgwgwgwgwgwgwgwgwg
wgwgwgwgwgwgwgwgwgwgwgwgwgwgwgwgwgwgwgwgwgwgwgwgwgwgwgwgwgwgwgwgwgwgwgwgwgwgwgwgwgwgwgwgwgwgwgwgwgwgwgwgwgwgwgwgwgwgwgwgwgwgwgwgwgwgwgwgwgwgwgwgwgwgwg
wgwgwgwgwgwgwgwgwgwgwgwgwgwgwgwgwgwgwgwgwgwgwgwgwgwgwgwgwgwgwgwgwgwgwgwgwgwgwgwgwgwgwgwgwgwgwgwgwgwgwgwgwgwgwgwgwgwgwgwgwgwgwgwgwgwgwgwgwgwgwgwgwgwgwg
wgwgwgwgwgwgwgwgwgwgwgwgwgwgwgwgwgwgwgwgwgwgwgwgwgwgwgwgwgwgwgwgwgwgwgwgwgwgwgwgwgwgwgwgwgwgwgwgwgwgwgwgwgwgwgwgwgwgwgwgwgwgwgwgwgwgwgwgwgwgwgwgwgwgwg
wgwgwgwgwgwgwgwgwgwgwgwgwgwgwgwgwgwgwgwgwgwgwgwgwgwgwgwgwgwgwgwgwgwgwgwgwgwgwgwgwgwgwgwgwgwgwgwgwgwgwgwgwgwgwgwgwgwgwgwgwgwgwgwgwgwgwgwgwgwgwgwgwgwgwg
wgwgwgwgwgwgwgwgwgwgwgwgwgwgwgwgwgwgwgwgwgwgwgwgwgwgPaPaPaPaPaPaPaPaPaPaPawgwgwgwgwgwgwgwgwgwgwgwgwgwgwgwgwgwgwgwgwgwgwgwgwgwgwgwgwgwgwgwgwgwgwgwgwgwg
wgwgwgwgwgwgwgwgwgwgwgwgwgwgwgwgwgwgwgwgwgwgwgwgwgPaPawgwgwgwgwgwgwgwgwgPaPawgwgwgwgwgwgwgwgwgwgwgwgwgwgwgwgwgwgwgwgwgwgwgwgwgwgwgwgwgwgwgwgwgwgwgwgwg
wgwgwgwgwgwgwgwgwgwgwgwgwgwgwgwgwgwgwgwgwgwgwgwgwgPawgwgPaPaPaPaPaPaPawgwgPawgwgwgwgwgwgwgwgwgwgwgwgwgwgwgwgwgwgwgwgwgwgwgwgwgwgwgwgwgwgwgwgwgwgwgwgwg
wgwgwgwgwgwgwgwgwgwgwgwgwgwgwgwgwgwgwgwgwgwgwgwgwgPawgPaPaOVLmuMjQuMPaPawgPaPaPaPaPaPaPawgwgwgwgwgwgwgwgwgwgwgwgwgwgwgwgwgwgwgwgwgwgwgwgwgwgwgwgwgwgwg
wgwgwgwgwgwgwgwgwgwgwgwgwgwgwgwgwgwgwgwgwgwgwgwgwgPawgPaLglklklklkyCKXPawgwgwgwgwgwgwgPaPaPawgwgwgwgwgwgwgwgwgwgwgwgwgwgwgwgwgwgwgwgwgwgwgwgwgwgwgwgwg
wgwgwgwgwgwgwgwgwgwgwgwgwgwgwgwgwgwgwgwgwgwgwgwgwgPawgPamXPsmXmXRLmXmXPaPaPaPaPaPaPawgwgwgPawgwgwgwgwgwgwgwgwgwgwgwgwgwgwgwgwgwgwgwgwgwgwgwgwgwgwgwgwg
wgwgwgwgwgwgwgwgwgwgwgwgwgwgwgwgwgwgwgwgwgwgwgwgwgPawgPaBtBtBtBtBtBtBtPalmlmlmlmlmPaPaPawgPawgwgwgwgwgwgwgwgwgwgwgwgwgwgwgwgwgwgwgwgwgwgwgwgwgwgwgwgwg
wgwgwgwgwgwgwgwgwgwgwgwgwgwgwgwgwgwgwgwgwgwgwgPaPaPawgPaBtPaWuPaPaPaPaPalmnLlmlmlmlmlmPawgPawgwgwgwgwgwgwgwgwgwgwgwgwgwgwgwgwgwgwgwgwgwgwgwgwgwgwgwgwg
wgwgwgwgwgwgwgwgwgwgwgwgwgwgwgwgwgwgwgwgwgwgPaPawgwgwgPaPaPaWuPaWuWuWuPalmlmlmnLlmlmlmPawgPawgwgwgwgwgwgwgwgwgwgwgwgwgwgwgwgwgwgwgwgwgwgwgwgwgwgwgwgwg
wgwgwgwgwgwgwgwgwgwgwgwgwgwgwgwgwgwgwgwgwgwgPawgwgPaPaPaWuWuWuPaWuPaWuPaWuPalmlmlmnLlmPawgPawgwgwgwgwgwgwgwgwgwgwgwgwgwgwgwgwgwgwgwgwgwgwgwgwgwgwgwgwg
wgwgwgwgwgwgwgwgwgwgwgwgwgwgwgwgwgwgwgwgwgwgPawgPaPaWuWuWuPaPaPaPaPaWuWuWuPaPalmlmlmlmPawgPawgwgwgwgwgwgwgwgwgwgwgwgwgwgwgwgwgwgwgwgwgwgwgwgwgwgwgwgwg
wgwgwgwgwgwgwgwgwgwgwgwgwgwgwgwgwgwgwgwgwgwgPawgPaWuWuPaPaPacXcXcXPaPaPaWuWuPaPaPaPaPaPawgPawgwgwgwgwgwgwgwgwgwgwgwgwgwgwgwgwgwgwgwgwgwgwgwgwgwgwgwgwg
wgwgwgwgwgwgwgwgwgwgwgwgwgwgwgwgwgwgwgwgwgwgPawgPaWuPaPaBeBecXcXcXBeBePaPaWuwgwgwgwgwgwgwgPawgwgwgwgwgwgwgwgwgwgwgwgwgwgwgwgwgwgwgwgwgwgwgwgwgwgwgwgwg
wgwgwgwgwgwgwgwgwgwgwgwgwgwgwgwgwgwgwgwgwgwgPawgPaWuPaBeBeBecXcXcXBeBeBePaWuPaPaPaPaPaPaPaPawgwgwgwgwgwgwgwgwgwgwgwgwgwgwgwgwgwgwgwgwgwgwgwgwgwgwgwgwg
wgwgwgwgwgwgwgwgwgwgwgwgwgwgwgwgwgwgwgwgwgwgPawgPaWuPaBeBeBeBeBeBeBeBeBePaWuPawgwgwgwgwgwgwgwgwgwgwgwgwgwgwgwgwgwgwgwgwgwgwgwgwgwgwgwgwgwgwgwgwgwgwgwg
wgwgwgwgwgwgwgwgwgwgwgwgwgwgwgwgwgwgwgwgwgwgPawgPaWuPaBeIQATBeQdBeIQATBePaWuPawgwgwgwgwgwgwgwgwgwgwgwgwgwgwgwgwgwgwgwgwgwgwgwgwgwgwgwgwgwgwgwgwgwgwgwg
wgwgwgwgwgwgwgwgwgwgwgwgwgwgwgwgwgwgwgwgwgwgPawgPaWuPaBeIQATBeQdBeIQATBePaWuPawgwgwgwgwgwgwgwgwgwgwgwgwgwgwgwgwgwgwgwgwgwgwgwgwgwgwgwgwgwgwgwgwgwgwgwg
wgwgwgwgwgwgwgwgwgwgwgwgwgwgwgwgwgwgwgwgwgwgPawgPaWuPaBeIQATBeQdBeIQATBePaWuPawgwgwgwgwgwgwgwgwgwgwgwgwgwgwgwgwgwgwgwgwgwgwgwgwgwgwgwgwgwgwgwgwgwgwgwg
wgwgwgwgwgwgwgwgwgwgwgwgwgwgwgwgwgwgwgwgwgwgPawgPaWuPaBeBeBeBeQdBeBeBeBePaWuPawgwgwgwgwgwgwgwgwgwgwgwgwgwgwgwgwgwgwgwgwgwgwgwgwgwgwgwgwgwgwgwgwgwgwgwg
wgwgwgwgwgwgwgwgwgwgwgwgwgwgwgwgwgwgwgwgwgwgPawgPaWuPaPaBeBeBeBeBeBeBePaPaWuPawgwgwgwgwgwgwgwgwgwgwgwgwgwgwgwgwgwgwgwgwgwgwgwgwgwgwgwgwgwgwgwgwgwgwgwg
wgwgwgwgwgwgwgwgwgwgwgwgwgwgwgwgwgwgwgwgwgwgPawgPaWuWuPaPaPaQdQdQdPaPaPaWuWuPawgwgwgwgwgwgwgwgwgwgwgwgwgwgwgwgwgwgwgwgwgwgwgwgwgwgwgwgwgwgwgwgwgwgwgwg
wgwgwgwgwgwgwgwgwgwgwgwgwgwgwgwgPaPaPaPaPaPaPawgPaPaWuWuWuPaQdQdQdPaWuWuWuPaPawgwgwgwgwgwgwgwgwgwgwgwgwgwgwgwgwgwgwgwgwgwgwgwgwgwgwgwgwgwgwgwgwgwgwgwg
wgwgwgwgwgwgwgwgwgwgwgwgwgwgwgwgPaWuWuWuWuWuWuWuWuPaPaPaWuPaQdQdQdPaWuPaPaPawgwgwgwgwgwgwgwgwgwgwgwgwgwgwgwgwgwgwgwgwgwgwgwgwgwgwgwgwgwgwgwgwgwgwgwgwg
wgwgwgwgwgwgwgwgwgwgwgwgwgwgwgwgPaWuPaPaPaPaPaPaWuWuWuPaWuPagFQdgFPaWuPawgwgwgwgwgwgwgwgwgwgwgwgwgwgwgwgwgwgwgwgwgwgwgwgwgwgwgwgwgwgwgwgwgwgwgwgwgwgwg
wgwgwgwgwgwgwgwgwgwgwgwgwgwgwgwgPaWuPaWuWuWuWuWuWuWuWuWuWuWugFgFgFWuWuPawgwgwgwgwgwgwgwgwgwgwgwgwgwgwgwgwgwgwgwgwgwgwgwgwgwgwgwgwgwgwgwgwgwgwgwgwgwgwg
wgwgwgwgwgwgwgwgwgwgwgwgwgwgPaPaPaWuPaWuPaPaPaPaPaPaPaPaPaPagFgFgFPaPaPawgwgwgwgwgwgwgwgwgwgwgwgwgwgwgwgwgwgwgwgwgwgwgwgwgwgwgwgwgwgwgwgwgwgwgwgwgwgwg
wgwgwgwgwgwgwgwgwgwgwgwgwgwgPaWuWuWuPaWuPaWuWuWuWuWuWuWuWuWugFgFgFPawgwgwgwgwgwgwgwgwgwgwgwgwgwgwgwgwgwgwgwgwgwgwgwgwgwgwgwgwgwgwgwgwgwgwgwgwgwgwgwgwg
wgwgwgwgwgwgwgwgwgwgwgwgwgwgPaWuPaPaPaWuPaWuPaWuPaPaPaPaPaPagFgFgFPaPaPaPaPaPaPaPaPawgwgwgwgwgwgwgwgwgwgwgwgwgwgwgwgwgwgwgwgwgwgwgwgwgwgwgwgwgwgwgwgwg
wgwgwgwgwgwgwgwgwgwgwgwgwgwgPaWuPaWuWuWuPaWuPaWuPaqwqwqwqwPagFgFgFPaAzfLfLgtgtUuUuPawgwgwgwgwgwgwgwgwgwgwgwgwgwgwgwgwgwgwgwgwgwgwgwgwgwgwgwgwgwgwgwgwg
wgwgwgwgwgwgwgwgwgwgwgwgwgwgPaWuPaWuWuWuPaWuPaPaPaqwqwqwqwPagFgFgFPaAzfLfLgtgtUuUuPawgwgwgwgwgwgwgwgwgwgwgwgwgwgwgwgwgwgwgwgwgwgwgwgwgwgwgwgwgwgwgwgwg
wgwgwgwgwgwgwgwgwgwgwgwgPaPaPaWuPaWuWuWuPaWuPaqwqwqwqwqwqwqwgFgFgFqUAzfLfLgtgtUuUuPawgwgPaPaPaPaPaPaPawgwgwgwgwgwgwgwgwgwgwgwgwgwgwgwgwgwgwgwgwgwgwgwg
wgwgwgwgwgwgwgwgwgwgwgwgPaWuWuWuPaPaPaPaPaWuPaqwqwqwqwqwqwCFgFgFgFPaAzfLfLgtgtUuUuPawgPaPaBGBGBGBGBGPaPawgwgwgwgwgwgwgwgwgwgwgwgwgwgwgwgwgwgwgwgwgwgwg
wgwgwgwgwgwgwgwgwgwgwgwgPaWuWuWuPaSFYnYnPaWuPaqwqwqwqwqwqwqwgFgFgFqUAzfLfLgtgtUuUuPawgPaBGBGBGBGBGBGBGPawgwgwgwgwgwgwgwgwgwgwgwgwgwgwgwgwgwgwgwgwgwgwg
wgwgwgwgwgwgwgwgwgwgwgwgPaWuWuWuPaKKYnYnWuWuPaPaPaqwqwqwqwPagFgFgFPaAzfLfLgtgtUuUuPawgPaBGBGBGBGBGBGBGPawgwgwgwgwgwgwgwgwgwgwgwgwgwgwgwgwgwgwgwgwgwgwg
wgwgwgwgwgwgwgwgwgwgwgwgPaWuWuWuPaSFYnYnPaWuWuWuPaqwqwqwqwPagFgFgFPaAzfLfLgtgtUuUuPawgPaBGBGBGBGBGBGBGPawgwgwgwgwgwgwgwgwgwgwgwgwgwgwgwgwgwgwgwgwgwgwg
wgwgwgwgwgwgwgwgwgwgwgwgPaPaPaPaPaPaPaPaPaWuPaPaPaPaPaPaPaPagFgFgFPaPaPaPaPaPaPaPaPaPaPaPaPaBGBGBGPaPaPaPawgwgwgwgwgwgwgwgwgwgwgwgwgwgwgwgwgwgwgwgwgwg
wgwgwgwgwgwgwgwgwgwgwgPaPatqyrtqIytqtqtqPaWuWuPatBzdKCJNhRfAgFgFgFPaGtvmolPaWuWuPaqlqlqlqlPaBGBGBGPawgwgwgwgwgwgwgwgwgwgwgwgwgwgwgwgwgwgwgwgwgwgwgwgwg
wgwgwgwgwgwgwgwgwgwgPaPawdtqtqtqtqtqaDtqtqWuWuWumYmYmYmYmYmYgFgFgFkWkWkWkWkWWuWuqlqlqlqlqlqlqlqlqlPaPaPaPawgwgwgwgwgwgwgwgwgwgwgwgwgwgwgwgwgwgwgwgwgwg
wgwgwgwgwgwgwgwgwgwgPatqtqtqtqtqxjtqtqtqtqWuWuWumYmYmYmYmYmYgFgFgFkWkWkWkWkWWuWuqlqlqlqlqlqlqlqlqlqlqlqlPawgwgwgwgwgwgwgwgwgwgwgwgwgwgwgwgwgwgwgwgwgwg
wgwgwgwgwgwgwgwgwgwgPatqyZtqtqIytqtqtqtqPaWuWuPatBzdKCJNhRfAgFgFgFPankshyMPaWuWuPaqlqlqlqlqlqlqlqlqlqlqlPawgwgwgwgwgwgwgwgwgwgwgwgwgwgwgwgwgwgwgwgwgwg
wgwgwgwgwgwgwgwgwgwgPatqtqtqtqtqtqtqtqPaPaWuWuPaPaPaPaPaPaPagFgFgFPaPaPaPaPaWuWuPaqlqlqlqlqlqlqlqlqlqlqlPaPaPaPaPaPaPaPaPaPawgwgwgwgwgwgwgwgwgwgwgwgwg
wgwgwgwgwgwgwgwgwgwgPaIytqtqwdtqJuIytqPaWuWuWuWuPaWuWuPaqYPaqYPaqYPaqYPaWuWuWuWuPaqlqlqlqlqlqlqlqlqlqlPaPaQHWnCoCoWnWnWnisPawgwgwgwgwgwgwgwgwgwgwgwgwg
wgwgwgwgwgwgwgwgwgwgPaDntqtqtqtqtqaDtqPaMwEeWuWuWuWuWuPaqYqYqYqYqYqYqYPaWuWuWuWuPaqlqlqlqlqlqlqlqlqlqlPaQHWnQHvMCoWnWnWnWlPawgwgwgwgwgwgwgwgwgwgwgwgwg
wgwgwgwgwgwgwgwgwgwgPaPaPaPatqtqtqtqtqPaWuWuWuWuPaWuWuPaqYqYqYqYqYqYqYPaWuWuPaPaPaPaPaPaPaqlqlqlqlqlPaPaWnQHWnvMvMvMvMvMvMPawgwgwgwgwgwgwgwgwgwgwgwgwg
wgwgwgwgwgwgwgwgwgwgwgwgwgPaPaPaPaPaPaPaPaPaPaPaPaWuWuPaqYqYqYqYqYqYqYPaWuWuCoCoCoCoCoCoPaPaqlqlqlPaPaWnQHWnQHCoCoWnWnWnisPawgwgwgwgwgwgwgwgwgwgwgwgwg
wgwgwgwgwgwgwgwgwgwgwgwgwgwgwgwgwgwgwgwgwgwgwgwgPaWuWuPaqYqYqYqYqYqYqYPaWuWuCoCoCoCoCoCoCoPaPaPaPaPaWnQHWnQHWnvMCoWnWnWnWlPawgwgwgwgwgwgwgwgwgwgwgwgwg
wgwgwgwgwgwgwgwgwgwgwgwgwgwgwgwgwgwgwgwgwgwgwgwgPaWuWuPaPaPaPaPaPaPaPaPaWuWuPaPaPaPaPaCoCoCoCoCoCoCoQHWnQHWnQHIsPRPRPRPRPRPawgwgwgwgwgwgwgwgwgwgwgwgwg
wgwgwgwgwgwgwgwgwgwgwgwgwgwgwgwgwgwgwgwgwgwgwgwgPaWuWuWuWuWuWuWuWuWuPaWuWuWuPawgwgwgPaPaPaPaPaPaPaPaWnQHWnQHWnvMCoWnWnWnWlPawgwgwgwgwgwgwgwgwgwgwgwgwg
wgwgwgwgwgwgwgwgwgwgwgwgwgwgwgwgwgwgwgwgwgwgwgwgPaWuWuWuPaPaPaPaPaPaPaWuWuWuPawgwgwgwgwgwgwgwgwgwgPaPaWnQHWnQHCoCoWnWnWnisPawgwgwgwgwgwgwgwgwgwgwgwgwg
wgwgwgwgwgwgwgwgwgwgwgwgwgwgwgwgwgwgwgwgwgwgwgwgPaWuWuPaPahXhXhXhXhXPaWuWuPaPawgwgwgwgwgwgwgwgwgwgwgPaPaWnQHWnvMvMvMvMvMvMPawgwgwgwgwgwgwgwgwgwgwgwgwg
wgwgwgwgwgwgwgwgwgwgwgwgwgwgwgwgwgwgwgwgwgwgwgwgPaWuWuPahXhXhXhXhXhXPaWuWuPawgwgwgwgwgwgwgwgwgwgwgwgwgPaQHWnQHvMCoWnWnWnWlPawgwgwgwgwgwgwgwgwgwgwgwgwg
wgwgwgwgwgwgwgwgwgwgwgwgwgwgwgwgwgwgwgwgwgwgwgwgPaWuWuPahXhXhXhXhXhXhXWuWuPawgwgwgwgwgwgwgwgwgwgwgwgwgPaPaQHWnCoCoWnWnWnisPawgwgwgwgwgwgwgwgwgwgwgwgwg
wgwgwgwgwgwgwgwgwgwgwgwgwgwgwgwgwgwgwgwgwgwgwgwgPaWuWuPahXhXhXhXhXhXPaWuWuPawgwgwgwgwgwgwgwgwgwgwgwgwgwgPaPaPaPaPaPaPaPaPaPawgwgwgwgwgwgwgwgwgwgwgwgwg
wgwgwgwgwgwgwgwgwgwgwgwgwgwgwgwgwgwgwgwgwgwgwgwgPaWuWuPaPahXhXhXhXhXPaWuWuPawgwgwgwgwgwgwgwgwgwgwgwgwgwgwgwgwgwgwgwgwgwgwgwgwgwgwgwgwgwgwgwgwgwgwgwgwg
wgwgwgwgwgwgwgwgwgwgwgwgwgwgwgwgwgwgwgwgwgwgwgwgPaPaWuWuPaPaPaPaPaPaPaWuWuPawgwgwgwgwgwgwgwgwgwgwgwgwgwgwgwgwgwgwgwgwgwgwgwgwgwgwgwgwgwgwgwgwgwgwgwgwg
wgwgwgwgwgwgwgwgwgwgwgwgwgwgwgwgwgwgwgwgwgwgwgwgwgPaPaWuWuWuWuWuWuWuWuWuPaPawgwgwgwgwgwgwgwgwgwgwgwgwgwgwgwgwgwgwgwgwgwgwgwgwgwgwgwgwgwgwgwgwgwgwgwgwg
wgwgwgwgwgwgwgwgwgwgwgwgwgwgwgwgwgwgwgwgwgwgwgwgwgwgPaPaPaPaPaPaPaPaPaPaPawgwgwgwgwgwgwgwgwgwgwgwgwgwgwgwgwgwgwgwgwgwgwgwgwgwgwgwgwgwgwgwgwgwgwgwgwgwg
wgwgwgwgwgwgwgwgwgwgwgwgwgwgwgwgwgwgwgwgwgwgwgwgwgwgwgwgwgwgwgwgwgwgwgwgwgwgwgwgwgwgwgwgwgwgwgwgwgwgwgwgwgwgwgwgwgwgwgwgwgwgwgwgwgwgwgwgwgwgwgwgwgwgwg
wgwgwgwgwgwgwgwgwgwgwgwgwgwgwgwgwgwgwgwgwgwgwgwgwgwgwgwgwgwgwgwgwgwgwgwgwgwgwgwgwgwgwgwgwgwgwgwgwgwgwgwgwgwgwgwgwgwgwgwgwgwgwgwgwgwgwgwgwgwgwgwgwgwgwg
wgwgwgwgwgwgwgwgwgwgwgwgwgwgwgwgwgwgwgwgwgwgwgwgwgwgwgwgwgwgwgwgwgwgwgwgwgwgwgwgwgwgwgwgwgwgwgwgwgwgwgwgwgwgwgwgwgwgwgwgwgwgwgwgwgwgwgwgwgwgwgwgwgwgwg
wgwgwgwgwgwgwgwgwgwgwgwgwgwgwgwgwgwgwgwgwgwgwgwgwgwgwgwgwgwgwgwgwgwgwgwgwgwgwgwgwgwgwgwgwgwgwgwgwgwgwgwgwgwgwgwgwgwgwgwgwgwgwgwgwgwgwgwgwgwgwgwgwgwgwg
wgwgwgwgwgwgwgwgwgwgwgwgwgwgwgwgwgwgwgwgwgwgwgwgwgwgwgwgwgwgwgwgwgwgwgwgwgwgwgwgwgwgwgwgwgwgwgwgwgwgwgwgwgwgwgwgwgwgwgwgwgwgwgwgwgwgwgwgwgwgwgwgwgwgwg
wgwgwgwgwgwgwgwgwgwgwgwgwgwgwgwgwgwgwgwgwgwgwgwgwgwgwgwgwgwgwgwgwgwgwgwgwgwgwgwgwgwgwgwgwgwgwgwgwgwgwgwgwgwgwgwgwgwgwgwgwgwgwgwgwgwgwgwgwgwgwgwgwgwgwg
wgwgwgwgwgwgwgwgwgwgwgwgwgwgwgwgwgwgwgwgwgwgwgwgwgwgwgwgwgwgwgwgwgwgwgwgwgwgwgwgwgwgwgwgwgwgwgwgwgwgwgwgwgwgwgwgwgwgwgwgwgwgwgwgwgwgwgwgwgwgwgwgwgwgwg
wgwgwgwgwgwgwgwgwgwgwgwgwgwgwgwgwgwgwgwgwgwgwgwgwgwgwgwgwgwgwgwgwgwgwgwgwgwgwgwgwgwgwgwgwgwgwgwgwgwgwgwgwgwgwgwgwgwgwgwgwgwgwgwgwgwgwgwgwgwgwgwgwgwgwg
wgwgwgwgwgwgwgwgwgwgwgwgwgwgwgwgwgwgwgwgwgwgwgwgwgwgwgwgwgwgwgwgwgwgwgwgwgwgwgwgwgwgwgwgwgwgwgwgwgwgwgwgwgwgwgwgwgwgwgwgwgwgwgwgwgwgwgwgwgwgwgwgwgwgwg
wgwgwgwgwgwgwgwgwgwgwgwgwgwgwgwgwgwgwgwgwgwgwgwgwgwgwgwgwgwgwgwgwgwgwgwgwgwgwgwgwgwgwgwgwgwgwgwgwgwgwgwgwgwgwgwgwgwgwgwgwgwgwgwgwgwgwgwgwgwgwgwgwgwgwg
wgwgwgwgwgwgwgwgwgwgwgwgwgwgwgwgwgwgwgwgwgwgwgwgwgwgwgwgwgwgwgwgwgwgwgwgwgwgwgwgwgwgwgwgwgwgwgwgwgwgwgwgwgwgwgwgwgwgwgwgwgwgwgwgwgwgwgwgwgwgwgwgwgwgwg
wgwgwgwgwgwgwgwgwgwgwgwgwgwgwgwgwgwgwgwgwgwgwgwgwgwgwgwgwgwgwgwgwgwgwgwgwgwgwgwgwgwgwgwgwgwgwgwgwgwgwgwgwgwgwgwgwgwgwgwgwgwgwgwgwgwgwgwgwgwgwgwgwgwgwg
"}
