"aW" = (/turf/simulated/floor/wood/bamboo,/area/space)
"en" = (/turf/simulated/floor/bluegrid,/area/space)
"fc" = (/obj/structure/bed/sofa/left/beige{dir = 1},/turf/simulated/floor/tiled,/area/space)
"fs" = (/turf/simulated/floor/tiled/skrell/blue,/area/space)
"if" = (/obj/machinery/power/apc/high{dir = 8; name = "west bump"; pixel_x = -24},/obj/structure/cable{icon_state = "0-1"; dir = 8},/turf/simulated/floor,/area/space)
"iD" = (/obj/machinery/computer/modular{dir = 4},/turf/simulated/floor/lino,/area/space)
"iF" = (/turf/simulated/floor/tiled/skrell/orange,/area/space)
"iK" = (/obj/structure/charge_pylon,/turf/simulated/floor/crystal,/area/space)
"iP" = (/obj/structure/flora/bush/stalkybush,/turf/simulated/floor/grass,/area/space)
"jQ" = (/obj/structure/bed/sofa/left/beige,/turf/simulated/floor/tiled,/area/space)
"jT" = (/obj/structure/bed/sofa/middle/beige{dir = 1},/turf/simulated/floor/tiled,/area/space)
"kw" = (/turf/simulated/floor/tiled/skrell/green,/area/space)
"lc" = (/obj/structure/flora/seaweed/glow,/turf/simulated/floor/beach/water/ocean,/area/space)
"lG" = (/turf/simulated/floor/wood/usedup,/area/space)
"mg" = (/obj/structure/flora/seaweed,/turf/simulated/floor/beach/water/ocean,/area/space)
"mL" = (/obj/structure/bed/chair/pew/mahogany,/turf/simulated/floor/wood/ebony,/area/space)
"mY" = (/turf/exterior/wildgrass,/area/space)
"ou" = (/obj/structure/flora/bush/pointybush,/turf/simulated/floor/grass,/area/space)
"pm" = (/obj/structure/flora/seaweed/mid,/turf/simulated/floor/beach/water,/area/space)
"pV" = (/obj/structure/flora/seaweed,/turf/simulated/floor/beach/coastline,/area/space)
"qF" = (/obj/structure/flora/grass/both,/turf/simulated/floor/grass,/area/space)
"rP" = (/obj/machinery/power/debug_items/infinite_generator,/obj/structure/cable{icon_state = "0-1"; dir = 4},/turf/simulated/floor,/area/space)
"rV" = (/turf/simulated/floor/reinforced,/area/space)
"rZ" = (/obj/structure/bed/sofa/right/beige{dir = 1},/turf/simulated/floor/tiled,/area/space)
"sI" = (/obj/effect/wallframe_spawn/reinforced,/turf/space,/area/space)
"wF" = (/turf/simulated/floor/crystal,/area/space)
"yk" = (/obj/structure/mineral_bath,/turf/simulated/floor/crystal,/area/space)
"yC" = (/obj/structure/flora/seaweed/large,/turf/simulated/floor/beach/water,/area/space)
"yE" = (/obj/structure/bed/sofa/middle/beige,/turf/simulated/floor/tiled,/area/space)
"yQ" = (/obj/machinery/vending/sol{dir = 8},/turf/simulated/floor/reinforced,/area/space)
"yS" = (/obj/machinery/computer/modular{dir = 8},/turf/simulated/floor/lino,/area/space)
"zA" = (/obj/structure/flora/grass/green,/turf/simulated/floor/grass,/area/space)
"AC" = (/obj/structure/flora/bush/grassybush,/turf/simulated/floor/grass,/area/space)
"Be" = (/turf/simulated/floor/tiled/white,/area/space)
"Bo" = (/turf/simulated/floor/carpet/red,/area/space)
"Cd" = (/obj/structure/flora/bush/fernybush,/turf/simulated/floor/grass,/area/space)
"Cj" = (/obj/structure/flora/bush/brflowers,/turf/simulated/floor/grass,/area/space)
"CM" = (/turf/simulated/floor/lino,/area/space)
"DD" = (/turf/simulated/floor/tiled/skrell/white,/area/space)
"Fz" = (/obj/structure/bed/chair/pew/left/mahogany,/turf/simulated/floor/wood/ebony,/area/space)
"FY" = (/obj/structure/flora/seaweed,/turf/simulated/floor/beach/water,/area/space)
"Hr" = (/obj/structure/flora/seaweed/mid,/turf/simulated/floor/beach/coastline,/area/space)
"IQ" = (/turf/space,/area/space)
"Jl" = (/turf/simulated/floor/greengrid,/area/space)
"Jo" = (/turf/simulated/floor/beach/water,/area/space)
"JD" = (/obj/effect/wallframe_spawn/reinforced,/turf/simulated/floor/reinforced,/area/space)
"JE" = (/obj/structure/aicore,/turf/simulated/floor/reinforced,/area/space)
"Kb" = (/obj/structure/bed/chair/padded/black{dir = 4},/turf/simulated/floor/lino,/area/space)
"Ko" = (/obj/structure/table/reinforced,/turf/simulated/floor/reinforced,/area/space)
"Ku" = (/turf/simulated/floor/beach/sand,/area/space)
"Kx" = (/obj/structure/flora/bush/palebush,/turf/simulated/floor/grass,/area/space)
"Lt" = (/obj/structure/flora/tree/pine,/turf/exterior/wildgrass,/area/space)
"NZ" = (/turf/simulated/floor/beach/water/ocean,/area/space)
"On" = (/turf/simulated/floor/tiled,/area/space)
"Qe" = (/obj/structure/bed/sofa/right/beige,/turf/simulated/floor/tiled,/area/space)
"QB" = (/turf/simulated/floor/wood/ebony,/area/space)
"Rx" = (/obj/effect/wallframe_spawn/reinforced,/turf/simulated/floor/lino,/area/space)
"RT" = (/turf/simulated/floor/tiled/monofloor,/area/space)
"Sa" = (/turf/simulated/floor/beach/coastline,/area/space)
"Sq" = (/obj/structure/table/woodentable/walnut,/turf/simulated/floor/lino,/area/space)
"SC" = (/turf/simulated/floor/tiled/skrell/red,/area/space)
"Tt" = (/turf/simulated/floor/grass,/area/space)
"Ur" = (/turf/simulated/floor,/area/space)
"US" = (/obj/structure/flora/seaweed/large,/turf/simulated/floor/beach/water/ocean,/area/space)
"Vt" = (/turf/simulated/floor/carpet/blue,/area/space)
"Wy" = (/turf/simulated/wall/ocp_wall,/area/space)
"WU" = (/obj/structure/bed/chair/padded/black{dir = 8},/turf/simulated/floor/lino,/area/space)
"Xu" = (/obj/effect/wallframe_spawn/reinforced,/turf/simulated/floor/wood/bamboo,/area/space)
"ZC" = (/turf/simulated/floor/wood/mahogany,/area/space)
"ZV" = (/turf/simulated/floor/tiled/stone,/area/space)

(1,1,1) = {"
IQIQIQIQIQIQIQIQIQIQIQIQIQIQIQIQIQIQIQIQIQIQIQIQIQIQIQIQIQIQIQIQIQIQIQIQIQIQIQIQIQIQIQIQIQIQIQIQIQIQIQIQIQIQIQIQIQIQIQIQIQIQIQIQIQIQIQIQIQIQIQIQIQIQIQ
IQIQIQIQIQIQIQIQIQIQIQIQIQIQIQIQIQIQIQIQIQIQIQIQIQIQIQIQIQIQIQIQIQIQIQIQIQIQIQIQIQIQIQIQIQIQIQIQIQIQIQIQIQIQIQIQIQIQIQIQIQIQIQIQIQIQIQIQIQIQIQIQIQIQIQ
IQIQIQIQIQIQIQIQIQIQIQIQIQIQIQIQIQIQIQIQIQIQIQIQIQIQIQIQIQIQIQIQIQIQIQIQIQIQIQIQIQIQIQIQIQIQIQIQIQIQIQIQIQIQIQIQIQIQIQIQIQIQIQIQIQIQIQIQIQIQIQIQIQIQIQ
IQIQIQIQIQIQIQIQIQIQIQIQIQIQIQIQIQIQIQIQIQIQIQIQIQIQIQIQIQIQIQIQIQIQIQIQIQIQIQIQIQIQIQIQIQIQIQIQIQIQIQIQIQIQIQIQIQIQIQIQIQIQIQIQIQIQIQIQIQIQIQIQIQIQIQ
IQIQIQIQIQIQIQIQIQIQIQIQIQIQIQIQIQIQIQIQIQIQIQIQIQIQIQIQIQIQIQIQIQIQIQIQIQIQIQIQIQIQIQIQIQIQIQIQIQIQIQIQIQIQIQIQIQIQIQIQIQIQIQIQIQIQIQIQIQIQIQIQIQIQIQ
IQIQIQIQIQIQIQIQIQIQIQIQIQIQIQIQIQIQIQIQIQIQIQIQIQIQIQIQIQIQIQIQIQIQIQIQIQIQIQIQIQIQIQIQIQIQIQIQIQIQIQIQIQIQIQIQIQIQIQIQIQIQIQIQIQIQIQIQIQIQIQIQIQIQIQ
IQIQIQIQIQIQIQIQIQIQIQIQIQIQIQIQIQIQIQIQIQIQIQIQIQIQWyWyWyWyWyWyWyWyWyWyWyIQIQIQIQIQIQIQIQIQIQIQIQIQIQIQIQIQIQIQIQIQIQIQIQIQIQIQIQIQIQIQIQIQIQIQIQIQIQ
IQIQIQIQIQIQIQIQIQIQIQIQIQIQIQIQIQIQIQIQIQIQIQIQIQWyWyIQIQIQIQIQIQIQIQIQWyWyIQIQIQIQIQIQIQIQIQIQIQIQIQIQIQIQIQIQIQIQIQIQIQIQIQIQIQIQIQIQIQIQIQIQIQIQIQ
IQIQIQIQIQIQIQIQIQIQIQIQIQIQIQIQIQIQIQIQIQIQIQIQIQWyIQIQWyWyWyWyWyWyWyIQIQWyIQIQIQIQIQIQIQIQIQIQIQIQIQIQIQIQIQIQIQIQIQIQIQIQIQIQIQIQIQIQIQIQIQIQIQIQIQ
IQIQIQIQIQIQIQIQIQIQIQIQIQIQIQIQIQIQIQIQIQIQIQIQIQWyIQWyWylcUSNZmgNZWyWyIQWyWyWyWyWyWyWyIQIQIQIQIQIQIQIQIQIQIQIQIQIQIQIQIQIQIQIQIQIQIQIQIQIQIQIQIQIQIQ
IQIQIQIQIQIQIQIQIQIQIQIQIQIQIQIQIQIQIQIQIQIQIQIQIQWyIQWyyCJoJoJoJoFYpmWyIQIQIQIQIQIQIQWyWyWyIQIQIQIQIQIQIQIQIQIQIQIQIQIQIQIQIQIQIQIQIQIQIQIQIQIQIQIQIQ
IQIQIQIQIQIQIQIQIQIQIQIQIQIQIQIQIQIQIQIQIQIQIQIQIQWyIQWySapVSaSaHrSaSaWyWyWyWyWyWyWyIQIQIQWyIQIQIQIQIQIQIQIQIQIQIQIQIQIQIQIQIQIQIQIQIQIQIQIQIQIQIQIQIQ
IQIQIQIQIQIQIQIQIQIQIQIQIQIQIQIQIQIQIQIQIQIQIQIQIQWyIQWyKuKuKuKuKuKuKuWymYmYmYmYmYWyWyWyIQWyIQIQIQIQIQIQIQIQIQIQIQIQIQIQIQIQIQIQIQIQIQIQIQIQIQIQIQIQIQ
IQIQIQIQIQIQIQIQIQIQIQIQIQIQIQIQIQIQIQIQIQIQIQWyWyWyIQWyKuWyUrWyWyWyWyWymYLtmYmYmYmYmYWyIQWyIQIQIQIQIQIQIQIQIQIQIQIQIQIQIQIQIQIQIQIQIQIQIQIQIQIQIQIQIQ
IQIQIQIQIQIQIQIQIQIQIQIQIQIQIQIQIQIQIQIQIQIQWyWyIQIQIQWyWyWyUrWyUrUrUrWymYmYmYLtmYmYmYWyIQWyIQIQIQIQIQIQIQIQIQIQIQIQIQIQIQIQIQIQIQIQIQIQIQIQIQIQIQIQIQ
IQIQIQIQIQIQIQIQIQIQIQIQIQIQIQIQIQIQIQIQIQIQWyIQIQWyWyWyUrUrUrWyUrWyUrWyUrWymYmYmYLtmYWyIQWyIQIQIQIQIQIQIQIQIQIQIQIQIQIQIQIQIQIQIQIQIQIQIQIQIQIQIQIQIQ
IQIQIQIQIQIQIQIQIQIQIQIQIQIQIQIQIQIQIQIQIQIQWyIQWyWyUrUrUrWyWyWyWyWyUrUrUrWyWymYmYmYmYWyIQWyIQIQIQIQIQIQIQIQIQIQIQIQIQIQIQIQIQIQIQIQIQIQIQIQIQIQIQIQIQ
IQIQIQIQIQIQIQIQIQIQIQIQIQIQIQIQIQIQIQIQIQIQWyIQWyUrUrWyWyWyVtVtVtWyWyWyUrUrWyWyWyWyWyWyIQWyIQIQIQIQIQIQIQIQIQIQIQIQIQIQIQIQIQIQIQIQIQIQIQIQIQIQIQIQIQ
IQIQIQIQIQIQIQIQIQIQIQIQIQIQIQIQIQIQIQIQIQIQWyIQWyUrWyWyQBQBVtVtVtQBQBWyWyUrIQIQIQIQIQIQIQWyIQIQIQIQIQIQIQIQIQIQIQIQIQIQIQIQIQIQIQIQIQIQIQIQIQIQIQIQIQ
IQIQIQIQIQIQIQIQIQIQIQIQIQIQIQIQIQIQIQIQIQIQWyIQWyUrWyQBQBQBVtVtVtQBQBQBWyUrWyWyWyWyWyWyWyWyIQIQIQIQIQIQIQIQIQIQIQIQIQIQIQIQIQIQIQIQIQIQIQIQIQIQIQIQIQ
IQIQIQIQIQIQIQIQIQIQIQIQIQIQIQIQIQIQIQIQIQIQWyIQWyUrWyQBQBQBQBQBQBQBQBQBWyUrWyIQIQIQIQIQIQIQIQIQIQIQIQIQIQIQIQIQIQIQIQIQIQIQIQIQIQIQIQIQIQIQIQIQIQIQIQ
IQIQIQIQIQIQIQIQIQIQIQIQIQIQIQIQIQIQIQIQIQIQWyIQWyUrWyQBmLFzQBBoQBmLFzQBWyUrWyIQIQIQIQIQIQIQIQIQIQIQIQIQIQIQIQIQIQIQIQIQIQIQIQIQIQIQIQIQIQIQIQIQIQIQIQ
IQIQIQIQIQIQIQIQIQIQIQIQIQIQIQIQIQIQIQIQIQIQWyIQWyUrWyQBmLFzQBBoQBmLFzQBWyUrWyIQIQIQIQIQIQIQIQIQIQIQIQIQIQIQIQIQIQIQIQIQIQIQIQIQIQIQIQIQIQIQIQIQIQIQIQ
IQIQIQIQIQIQIQIQIQIQIQIQIQIQIQIQIQIQIQIQIQIQWyIQWyUrWyQBmLFzQBBoQBmLFzQBWyUrWyIQIQIQIQIQIQIQIQIQIQIQIQIQIQIQIQIQIQIQIQIQIQIQIQIQIQIQIQIQIQIQIQIQIQIQIQ
IQIQIQIQIQIQIQIQIQIQIQIQIQIQIQIQIQIQIQIQIQIQWyIQWyUrWyQBQBQBQBBoQBQBQBQBWyUrWyIQIQIQIQIQIQIQIQIQIQIQIQIQIQIQIQIQIQIQIQIQIQIQIQIQIQIQIQIQIQIQIQIQIQIQIQ
IQIQIQIQIQIQIQIQIQIQIQIQIQIQIQIQIQIQIQIQIQIQWyIQWyUrWyWyQBQBQBQBQBQBQBWyWyUrWyIQIQIQIQIQIQIQIQIQIQIQIQIQIQIQIQIQIQIQIQIQIQIQIQIQIQIQIQIQIQIQIQIQIQIQIQ
IQIQIQIQIQIQIQIQIQIQIQIQIQIQIQIQIQIQIQIQIQIQWyIQWyUrUrWyWyWyBoBoBoWyWyWyUrUrWyIQIQIQIQIQIQIQIQIQIQIQIQIQIQIQIQIQIQIQIQIQIQIQIQIQIQIQIQIQIQIQIQIQIQIQIQ
IQIQIQIQIQIQIQIQIQIQIQIQIQIQIQIQWyWyWyWyWyWyWyIQWyWyUrUrUrWyBoBoBoWyUrUrUrWyWyIQIQIQIQIQIQIQIQIQIQIQIQIQIQIQIQIQIQIQIQIQIQIQIQIQIQIQIQIQIQIQIQIQIQIQIQ
IQIQIQIQIQIQIQIQIQIQIQIQIQIQIQIQWyUrUrUrUrUrUrUrUrWyWyWyUrWyBoBoBoWyUrWyWyWyIQIQIQIQIQIQIQIQIQIQIQIQIQIQIQIQIQIQIQIQIQIQIQIQIQIQIQIQIQIQIQIQIQIQIQIQIQ
IQIQIQIQIQIQIQIQIQIQIQIQIQIQIQIQWyUrWyWyWyWyWyWyUrUrUrWyUrWyZCBoZCWyUrWyIQIQIQIQIQIQIQIQIQIQIQIQIQIQIQIQIQIQIQIQIQIQIQIQIQIQIQIQIQIQIQIQIQIQIQIQIQIQIQ
IQIQIQIQIQIQIQIQIQIQIQIQIQIQIQIQWyUrWyUrUrUrUrUrUrUrUrUrUrUrZCZCZCUrUrWyIQIQIQIQIQIQIQIQIQIQIQIQIQIQIQIQIQIQIQIQIQIQIQIQIQIQIQIQIQIQIQIQIQIQIQIQIQIQIQ
IQIQIQIQIQIQIQIQIQIQIQIQIQIQWyWyWyUrWyUrWyWyWyWyWyWyWyWyWyWyZCZCZCWyWyWyIQIQIQIQIQIQIQIQIQIQIQIQIQIQIQIQIQIQIQIQIQIQIQIQIQIQIQIQIQIQIQIQIQIQIQIQIQIQIQ
IQIQIQIQIQIQIQIQIQIQIQIQIQIQWyUrUrUrWyUrWyUrUrUrUrUrUrUrUrUrZCZCZCWyIQIQIQIQIQIQIQIQIQIQIQIQIQIQIQIQIQIQIQIQIQIQIQIQIQIQIQIQIQIQIQIQIQIQIQIQIQIQIQIQIQ
IQIQIQIQIQIQIQIQIQIQIQIQIQIQWyUrWyWyWyUrWyUrWyUrWyWyWyWyWyWyZCZCZCWyWyWyWyWyWyWyWyWyIQIQIQIQIQIQIQIQIQIQIQIQIQIQIQIQIQIQIQIQIQIQIQIQIQIQIQIQIQIQIQIQIQ
IQIQIQIQIQIQIQIQIQIQIQIQIQIQWyUrWyUrUrUrWyUrWyUrWyaWaWaWaWWyZCZCZCWySCiFiFkwkwfsfsWyIQIQIQIQIQIQIQIQIQIQIQIQIQIQIQIQIQIQIQIQIQIQIQIQIQIQIQIQIQIQIQIQIQ
IQIQIQIQIQIQIQIQIQIQIQIQIQIQWyUrWyUrUrUrWyUrWyWyWyaWaWaWaWWyZCZCZCWySCiFiFkwkwfsfsWyIQIQIQIQIQIQIQIQIQIQIQIQIQIQIQIQIQIQIQIQIQIQIQIQIQIQIQIQIQIQIQIQIQ
IQIQIQIQIQIQIQIQIQIQIQIQWyWyWyUrWyUrUrUrWyUrWyaWaWaWaWaWaWaWZCZCZCDDSCiFiFkwkwfsfsWyIQIQWyWyWyWyWyWyWyIQIQIQIQIQIQIQIQIQIQIQIQIQIQIQIQIQIQIQIQIQIQIQIQ
IQIQIQIQIQIQIQIQIQIQIQIQWyUrUrUrWyWyWyWyWyUrWyaWaWaWaWaWaWXuZCZCZCWySCiFiFkwkwfsfsWyIQWyWyBeBeBeBeBeWyWyIQIQIQIQIQIQIQIQIQIQIQIQIQIQIQIQIQIQIQIQIQIQIQ
IQIQIQIQIQIQIQIQIQIQIQIQWyUrUrUrWyykwFwFWyUrWyaWaWaWaWaWaWaWZCZCZCDDSCiFiFkwkwfsfsWyIQWyBeBeBeBeBeBeBeWyIQIQIQIQIQIQIQIQIQIQIQIQIQIQIQIQIQIQIQIQIQIQIQ
IQIQIQIQIQIQIQIQIQIQIQIQWyUrUrUrWyiKwFwFUrUrWyWyWyaWaWaWaWWyZCZCZCWySCiFiFkwkwfsfsWyIQWyBeBeBeBeBeBeBeWyIQIQIQIQIQIQIQIQIQIQIQIQIQIQIQIQIQIQIQIQIQIQIQ
IQIQIQIQIQIQIQIQIQIQIQIQWyUrUrUrWyykwFwFWyUrUrUrWyaWaWaWaWWyZCZCZCWySCiFiFkwkwfsfsWyIQWyBeBeBeBeBeBeBeWyIQIQIQIQIQIQIQIQIQIQIQIQIQIQIQIQIQIQIQIQIQIQIQ
IQIQIQIQIQIQIQIQIQIQIQIQWyWyWyWyWyWyWyWyWyUrWyWyWyWyWyWyWyWyZCZCZCWyWyWyWyWyWyWyWyWyWyWyWyWyBeBeBeWyWyWyWyIQIQIQIQIQIQIQIQIQIQIQIQIQIQIQIQIQIQIQIQIQIQ
IQIQIQIQIQIQIQIQIQIQIQWyWyTtouTtCjTtTtTtWyUrUrWyiDWUSqKbySRxZCZCZCWyjQyEQeWyUrUrWyZVZVZVZVWyBeBeBeWyIQIQIQIQIQIQIQIQIQIQIQIQIQIQIQIQIQIQIQIQIQIQIQIQIQ
IQIQIQIQIQIQIQIQIQIQWyWyzATtTtTtTtTtqFTtTtUrUrUrCMCMCMCMCMCMZCZCZCOnOnOnOnOnUrUrZVZVZVZVZVZVZVZVZVWyWyWyWyIQIQIQIQIQIQIQIQIQIQIQIQIQIQIQIQIQIQIQIQIQIQ
IQIQIQIQIQIQIQIQIQIQWyTtTtTtTtTtKxTtTtTtTtUrUrUrCMCMCMCMCMCMZCZCZCOnOnOnOnOnUrUrZVZVZVZVZVZVZVZVZVZVZVZVWyIQIQIQIQIQIQIQIQIQIQIQIQIQIQIQIQIQIQIQIQIQIQ
IQIQIQIQIQIQIQIQIQIQWyTtCdTtTtCjTtTtTtTtWyUrUrWyiDWUSqKbySRxZCZCZCWyrZjTfcWyUrUrWyZVZVZVZVZVZVZVZVZVZVZVWyIQIQIQIQIQIQIQIQIQIQIQIQIQIQIQIQIQIQIQIQIQIQ
IQIQIQIQIQIQIQIQIQIQWyTtTtTtTtTtTtTtTtWyWyUrUrWyWyWyWyWyWyWyZCZCZCWyWyWyWyWyUrUrWyZVZVZVZVZVZVZVZVZVZVZVWyWyWyWyWyWyWyWyWyWyIQIQIQIQIQIQIQIQIQIQIQIQIQ
IQIQIQIQIQIQIQIQIQIQWyCjTtTtzATtACCjTtWyUrUrUrUrWyUrUrWylGWylGWylGWylGWyUrUrUrUrWyZVZVZVZVZVZVZVZVZVZVWyWyJlenrVrVenenenyQWyIQIQIQIQIQIQIQIQIQIQIQIQIQ
IQIQIQIQIQIQIQIQIQIQWyiPTtTtTtTtTtqFTtWyifrPUrUrUrUrUrWylGlGlGlGlGlGlGWyUrUrUrUrWyZVZVZVZVZVZVZVZVZVZVWyJlenJlJDrVenenenKoWyIQIQIQIQIQIQIQIQIQIQIQIQIQ
IQIQIQIQIQIQIQIQIQIQWyWyWyWyTtTtTtTtTtWyUrUrUrUrWyUrUrWylGlGlGlGlGlGlGWyUrUrWyWyWyWyWyWyWyZVZVZVZVZVWyWyenJlenJDJDJDJDJDJDWyIQIQIQIQIQIQIQIQIQIQIQIQIQ
IQIQIQIQIQIQIQIQIQIQIQIQIQWyWyWyWyWyWyWyWyWyWyWyWyUrUrWylGlGlGlGlGlGlGWyUrUrrVrVrVrVrVrVWyWyZVZVZVWyWyenJlenJlrVrVenenenyQWyIQIQIQIQIQIQIQIQIQIQIQIQIQ
IQIQIQIQIQIQIQIQIQIQIQIQIQIQIQIQIQIQIQIQIQIQIQIQWyUrUrWylGlGlGlGlGlGlGWyUrUrrVrVrVrVrVrVrVWyWyWyWyWyenJlenJlenJDrVenenenKoWyIQIQIQIQIQIQIQIQIQIQIQIQIQ
IQIQIQIQIQIQIQIQIQIQIQIQIQIQIQIQIQIQIQIQIQIQIQIQWyUrUrWyWyWyWyWyWyWyWyWyUrUrWyWyWyWyWyrVrVrVrVrVrVrVJlenJlenJlJEsIsIsIsIsIWyIQIQIQIQIQIQIQIQIQIQIQIQIQ
IQIQIQIQIQIQIQIQIQIQIQIQIQIQIQIQIQIQIQIQIQIQIQIQWyUrUrUrUrUrUrUrUrUrWyUrUrUrWyIQIQIQWyWyWyWyWyWyWyWyenJlenJlenJDrVenenenKoWyIQIQIQIQIQIQIQIQIQIQIQIQIQ
IQIQIQIQIQIQIQIQIQIQIQIQIQIQIQIQIQIQIQIQIQIQIQIQWyUrUrUrWyWyWyWyWyWyWyUrUrUrWyIQIQIQIQIQIQIQIQIQIQWyWyenJlenJlrVrVenenenyQWyIQIQIQIQIQIQIQIQIQIQIQIQIQ
IQIQIQIQIQIQIQIQIQIQIQIQIQIQIQIQIQIQIQIQIQIQIQIQWyUrUrWyWyRTRTRTRTRTWyUrUrWyWyIQIQIQIQIQIQIQIQIQIQIQWyWyenJlenJDJDJDJDJDJDWyIQIQIQIQIQIQIQIQIQIQIQIQIQ
IQIQIQIQIQIQIQIQIQIQIQIQIQIQIQIQIQIQIQIQIQIQIQIQWyUrUrWyRTRTRTRTRTRTWyUrUrWyIQIQIQIQIQIQIQIQIQIQIQIQIQWyJlenJlJDrVenenenKoWyIQIQIQIQIQIQIQIQIQIQIQIQIQ
IQIQIQIQIQIQIQIQIQIQIQIQIQIQIQIQIQIQIQIQIQIQIQIQWyUrUrWyRTRTRTRTRTRTRTUrUrWyIQIQIQIQIQIQIQIQIQIQIQIQIQWyWyJlenrVrVenenenyQWyIQIQIQIQIQIQIQIQIQIQIQIQIQ
IQIQIQIQIQIQIQIQIQIQIQIQIQIQIQIQIQIQIQIQIQIQIQIQWyUrUrWyRTRTRTRTRTRTWyUrUrWyIQIQIQIQIQIQIQIQIQIQIQIQIQIQWyWyWyWyWyWyWyWyWyWyIQIQIQIQIQIQIQIQIQIQIQIQIQ
IQIQIQIQIQIQIQIQIQIQIQIQIQIQIQIQIQIQIQIQIQIQIQIQWyUrUrWyWyRTRTRTRTRTWyUrUrWyIQIQIQIQIQIQIQIQIQIQIQIQIQIQIQIQIQIQIQIQIQIQIQIQIQIQIQIQIQIQIQIQIQIQIQIQIQ
IQIQIQIQIQIQIQIQIQIQIQIQIQIQIQIQIQIQIQIQIQIQIQIQWyWyUrUrWyWyWyWyWyWyWyUrUrWyIQIQIQIQIQIQIQIQIQIQIQIQIQIQIQIQIQIQIQIQIQIQIQIQIQIQIQIQIQIQIQIQIQIQIQIQIQ
IQIQIQIQIQIQIQIQIQIQIQIQIQIQIQIQIQIQIQIQIQIQIQIQIQWyWyUrUrUrUrUrUrUrUrUrWyWyIQIQIQIQIQIQIQIQIQIQIQIQIQIQIQIQIQIQIQIQIQIQIQIQIQIQIQIQIQIQIQIQIQIQIQIQIQ
IQIQIQIQIQIQIQIQIQIQIQIQIQIQIQIQIQIQIQIQIQIQIQIQIQIQWyWyWyWyWyWyWyWyWyWyWyIQIQIQIQIQIQIQIQIQIQIQIQIQIQIQIQIQIQIQIQIQIQIQIQIQIQIQIQIQIQIQIQIQIQIQIQIQIQ
IQIQIQIQIQIQIQIQIQIQIQIQIQIQIQIQIQIQIQIQIQIQIQIQIQIQIQIQIQIQIQIQIQIQIQIQIQIQIQIQIQIQIQIQIQIQIQIQIQIQIQIQIQIQIQIQIQIQIQIQIQIQIQIQIQIQIQIQIQIQIQIQIQIQIQ
IQIQIQIQIQIQIQIQIQIQIQIQIQIQIQIQIQIQIQIQIQIQIQIQIQIQIQIQIQIQIQIQIQIQIQIQIQIQIQIQIQIQIQIQIQIQIQIQIQIQIQIQIQIQIQIQIQIQIQIQIQIQIQIQIQIQIQIQIQIQIQIQIQIQIQ
IQIQIQIQIQIQIQIQIQIQIQIQIQIQIQIQIQIQIQIQIQIQIQIQIQIQIQIQIQIQIQIQIQIQIQIQIQIQIQIQIQIQIQIQIQIQIQIQIQIQIQIQIQIQIQIQIQIQIQIQIQIQIQIQIQIQIQIQIQIQIQIQIQIQIQ
IQIQIQIQIQIQIQIQIQIQIQIQIQIQIQIQIQIQIQIQIQIQIQIQIQIQIQIQIQIQIQIQIQIQIQIQIQIQIQIQIQIQIQIQIQIQIQIQIQIQIQIQIQIQIQIQIQIQIQIQIQIQIQIQIQIQIQIQIQIQIQIQIQIQIQ
IQIQIQIQIQIQIQIQIQIQIQIQIQIQIQIQIQIQIQIQIQIQIQIQIQIQIQIQIQIQIQIQIQIQIQIQIQIQIQIQIQIQIQIQIQIQIQIQIQIQIQIQIQIQIQIQIQIQIQIQIQIQIQIQIQIQIQIQIQIQIQIQIQIQIQ
IQIQIQIQIQIQIQIQIQIQIQIQIQIQIQIQIQIQIQIQIQIQIQIQIQIQIQIQIQIQIQIQIQIQIQIQIQIQIQIQIQIQIQIQIQIQIQIQIQIQIQIQIQIQIQIQIQIQIQIQIQIQIQIQIQIQIQIQIQIQIQIQIQIQIQ
IQIQIQIQIQIQIQIQIQIQIQIQIQIQIQIQIQIQIQIQIQIQIQIQIQIQIQIQIQIQIQIQIQIQIQIQIQIQIQIQIQIQIQIQIQIQIQIQIQIQIQIQIQIQIQIQIQIQIQIQIQIQIQIQIQIQIQIQIQIQIQIQIQIQIQ
IQIQIQIQIQIQIQIQIQIQIQIQIQIQIQIQIQIQIQIQIQIQIQIQIQIQIQIQIQIQIQIQIQIQIQIQIQIQIQIQIQIQIQIQIQIQIQIQIQIQIQIQIQIQIQIQIQIQIQIQIQIQIQIQIQIQIQIQIQIQIQIQIQIQIQ
IQIQIQIQIQIQIQIQIQIQIQIQIQIQIQIQIQIQIQIQIQIQIQIQIQIQIQIQIQIQIQIQIQIQIQIQIQIQIQIQIQIQIQIQIQIQIQIQIQIQIQIQIQIQIQIQIQIQIQIQIQIQIQIQIQIQIQIQIQIQIQIQIQIQIQ
IQIQIQIQIQIQIQIQIQIQIQIQIQIQIQIQIQIQIQIQIQIQIQIQIQIQIQIQIQIQIQIQIQIQIQIQIQIQIQIQIQIQIQIQIQIQIQIQIQIQIQIQIQIQIQIQIQIQIQIQIQIQIQIQIQIQIQIQIQIQIQIQIQIQIQ
IQIQIQIQIQIQIQIQIQIQIQIQIQIQIQIQIQIQIQIQIQIQIQIQIQIQIQIQIQIQIQIQIQIQIQIQIQIQIQIQIQIQIQIQIQIQIQIQIQIQIQIQIQIQIQIQIQIQIQIQIQIQIQIQIQIQIQIQIQIQIQIQIQIQIQ
IQIQIQIQIQIQIQIQIQIQIQIQIQIQIQIQIQIQIQIQIQIQIQIQIQIQIQIQIQIQIQIQIQIQIQIQIQIQIQIQIQIQIQIQIQIQIQIQIQIQIQIQIQIQIQIQIQIQIQIQIQIQIQIQIQIQIQIQIQIQIQIQIQIQIQ
"}
